W,W,W,W,W,W,W,W
W,W,W,N,W,W,W,W
W,W,N,E,N,W,W,W
W,W,W,N,W,W,W,W
W,N,N,T,N,N,W,W
W,N,N,T,N,N,W,W
W,N,N,T,N,N,W,W
W,W,W,N,W,W,W,W
W,N,N,S,N,N,W,W
W,N,N,N,N,N,W,W
W,W,W,W,W,W,W,W
W,W,W,W,W,W,W,W
