S,N,I,I,I,N
N,N,I,N,N,W
W,W,N,N,I,N
N,N,T,W,W,W
N,W,I,N,N,N
N,W,I,N,W,N
T,W,I,N,W,N
N,N,N,N,W,E