S,W,N,W,N
N,W,N,W,N
N,W,N,W,N
N,W,I,W,N
N,W,I,W,N
N,W,I,W,N
T,N,N,N,N
I,W,T,W,N
I,W,N,W,N
I,W,W,W,N
I,W,N,N,N
N,W,N,W,N
N,N,N,W,E
